111111111111111111111111111111111111111111111
110101010100000000000000010101010101011101011
110111010111011101110111010101010101011101111
110111010111011101110111010101011101011101111
110111010111011101110111010101011101C11101111
110101010111010101110101010101010101011101011
110101010111010101110101010101010101011101011
110111010111011101110111010101011101P11101111
110111010111011101110111010101011101011101111
110111010111011101110111010101011101011101111
110101010111010101110101C10101010101011101011
11010101011101010111010101010101010111101011
110111010111011101110111010101011101011101111
111111111111111111111111111111111111111111111