11111111111111111111
10001111111111111111
1000000000000000P001
10001011100000001111
10111000000000000001
10111111111111111111
1000000000000CCC0011
1E111010111111110101
11111111111111111111
